###############
# O    .    . #
###########   #
###########   #
# . ## .    . #
#   ##   ##   #
#   ##   ##   #
# .    .    E #
###############
